1111111111111111111
1P10000C0000C0001E1
1C1011100C001000101
1010101000001000101
100010100C00C000C01
1111111111111111111