111111111111111
1E00000000C0001
1111P00000000C1
100000011111111
11000000000C111
111111111111111