1111111111
100C100101
100110E001
1P00000101
1111111111
