1111111
100C0E1
100P001
1C00001
1111111